antiguo / antigua	ancien / ancienne	[sound:ancien _ ancienne.mp3]
otro / otra	autre / autre	[sound:autre _ autre.mp3]
bonito / bonita	beau / belle	[sound:beau _ belle.mp3]
extraño / extraña	bizarre / bizarre	[sound:bizarre _ bizarre.mp3]
blanco / blanca	blanc / blanche	[sound:blanc _ blanche.mp3]
azul / azul	bleu / bleue	[sound:bleu _ bleue.mp3]
bueno / buena	bon / bonne	[sound:bon _ bonne.mp3]
seguro / segura	certain / certaine	[sound:certain _ certaine.mp3]
caliente / caliente	chaud / chaude	[sound:chaud _ chaude.mp3]
caro / cara	cher / chère	[sound:cher _ chère.mp3]
claro / clara	clair / claire	[sound:clair _ claire.mp3]
contento / contenta	content / contente	[sound:content _ contente.mp3]
último / última	dernier / dernière	[sound:dernier _ dernière.mp3]
arrepentido / arrepentida	désolé / désolée	[sound:désolé _ désolée.mp3]
diferente / diferente	différent / différente	[sound:différent _ différente.mp3]
difícil / difícil	difficile / difficile	[sound:difficile _ difficile.mp3]
suave / suave	doux / douce	[sound:doux _ douce.mp3]
gracioso / graciosa	drôle / drôle	[sound:drôle _ drôle.mp3]
entero / entera	entier / entière	[sound:entier _ entière.mp3]
extraño / extraña	étrange / étrange	[sound:étrange _ étrange.mp3]
fácil / fácil	facile / facile	[sound:facile _ facile.mp3]
falso / falsa	faux / fausse	[sound:faux _ fausse.mp3]
fuerte / fuerte	fort / forte	[sound:fort _ forte.mp3]
francés / francesa	français / française	[sound:français _ française.mp3]
frío / fría	froid / froide	[sound:froid _ froide.mp3]
amable / amable	gentil / gentille	[sound:gentil _ gentille.mp3]
grande / grande	grand / grande	[sound:grand _ grande.mp3]
grave / grave	grave / grave	[sound:grave _ grave.mp3]
gordo / gorda	gros / grosse	[sound:gros _ grosse.mp3]
alto / alta	haut / haute	[sound:haut _ haute.mp3]
feliz / feliz	heureux / heureuse	[sound:heureux _ heureuse.mp3]
humano / humana	humain / humaine	[sound:humain _ humaine.mp3]
importante / importante	important / importante	[sound:important _ importante.mp3]
imposible / imposible	impossible / impossible	[sound:impossible _ impossible.mp3]
joven / joven	jeune / jeune	[sound:jeune _ jeune.mp3]
lindo / linda	joli / jolie	[sound:joli _ jolie.mp3]
justo / justa	juste / juste	[sound:juste _ juste.mp3]
ligero / ligera	léger / légère	[sound:léger _ légère.mp3]
libre / libre	libre / libre	[sound:libre _ libre.mp3]
largo / larga	long / longue	[sound:long _ longue.mp3]
enfermo / enferma	malade / malade	[sound:malade _ malade.mp3]
malo / mala	mauvais / mauvaise	[sound:mauvais _ mauvaise.mp3]
mejor / mejor	meilleur / meilleure	[sound:meilleur _ meilleure.mp3]
mismo / misma	même / même	[sound:même _ même.mp3]
muerto / muerta	mort / morte	[sound:mort _ morte.mp3]
negro / negra	noir / noire	[sound:noir _ noire.mp3]
nuevo / nueva	nouveau / nouvelle	[sound:nouveau _ nouvelle.mp3]
igual / igual	pareil / pareille	[sound:pareil _ pareille.mp3]
pobre / pobre	pauvre / pauvre	[sound:pauvre _ pauvre.mp3]
pequeño / pequeña	petit / petite	[sound:petit _ petite.mp3]
lleno / llena	plein / pleine	[sound:plein _ pleine.mp3]
posible / posible	possible / possible	[sound:possible _ possible.mp3]
primero / primera	premier / première	[sound:premier _ première.mp3]
listo / lista	prêt / prête	[sound:prêt _ prête.mp3]
próximo / próxima	prochain / prochaine	[sound:prochain _ prochaine.mp3]
limpio / limpia	propre / propre	[sound:propre _ propre.mp3]
qué / qué	quoi / quoi	[sound:quoi _ quoi.mp3]
rojo / roja	rouge / rouge	[sound:rouge _ rouge.mp3]
sucio / sucia	sale / sale	[sound:sale _ sale.mp3]
serio / seria	sérieux / sérieuse	[sound:sérieux _ sérieuse.mp3]
solo / sola	seul / seule	[sound:seul _ seule.mp3]
sencillo / sencilla	simple / simple	[sound:simple _ simple.mp3]
súper / súper	super / super	[sound:super _ super.mp3]
todo / toda	tout / toute	[sound:tout _ toute.mp3]
tranquilo / tranquila	tranquille / tranquille	[sound:tranquille _ tranquille.mp3]
triste / triste	triste / triste	[sound:triste _ triste.mp3]
verde / verde	vert / verte	[sound:vert _ verte.mp3]
vacío / vacía	vide / vide	[sound:vide _ vide.mp3]
viejo / vieja	vieux / vieille	[sound:vieux _ vieille.mp3]
vivo / viva	vivant / vivante	[sound:vivant _ vivante.mp3]
verdadero / verdadera	vrai / vraie	[sound:vrai _ vraie.mp3]
asunto	l'affaire	[sound:l'affaire.mp3]
ayuda	l'aide	[sound:l'aide.mp3]
año	l'année	[sound:l'année.mp3]
arma	l'arme	[sound:l'arme.mp3]
ejército	l'armée	[sound:l'armée.mp3]
atención	l'attention	[sound:l'attention.mp3]
bola	la balle	[sound:la balle.mp3]
caja	la boîte	[sound:la boîte.mp3]
boca	la bouche	[sound:la bouche.mp3]
tarjeta	la carte	[sound:la carte.mp3]
causa	la cause	[sound:la cause.mp3]
habitación	la chambre	[sound:la chambre.mp3]
suerte	la chance	[sound:la chance.mp3]
cosa	la chose	[sound:la chose.mp3]
clase	la classe	[sound:la classe.mp3]
confianza	la confiance	[sound:la confiance.mp3]
color	la couleur	[sound:la couleur.mp3]
patio	la cour	[sound:la cour.mp3]
cocina	la cuisine	[sound:la cuisine.mp3]
señora	la dame	[sound:la dame.mp3]
diente	la dent	[sound:la dent.mp3]
derecha	la droite	[sound:la droite.mp3]
escuela	l'école	[sound:l'école.mp3]
iglesia	l'église	[sound:l'église.mp3]
ganas	l'envie	[sound:l'envie.mp3]
hombro	l'épaule	[sound:l'épaule.mp3]
época	l'époque	[sound:l'époque.mp3]
equipo	l'équipe	[sound:l'équipe.mp3]
error	l'erreur	[sound:l'erreur.mp3]
especie	l'espèce	[sound:l'espèce.mp3]
cara	la face	[sound:la face.mp3]
manera	la façon	[sound:la façon.mp3]
hambre	la faim	[sound:la faim.mp3]
familia	la famille	[sound:la famille.mp3]
culpa	la faute	[sound:la faute.mp3]
mujer	la femme	[sound:la femme.mp3]
ventana	la fenêtre	[sound:la fenêtre.mp3]
fiesta	la fête	[sound:la fête.mp3]
chica	la fille	[sound:la fille.mp3]
flor	la fleur	[sound:la fleur.mp3]
vez	la fois	[sound:la fois.mp3]
fuerza	la force	[sound:la force.mp3]
forma	la forme	[sound:la forme.mp3]
izquierda	la gauche	[sound:la gauche.mp3]
guerra	la guerre	[sound:la guerre.mp3]
boca (animales)	la gueule	[sound:la gueule.mp3]
costumbre	la habitude	[sound:la habitude.mp3]
hora	la heure	[sound:la heure.mp3]
historia	la histoire	[sound:la histoire.mp3]
idea	l'idée	[sound:l'idée.mp3]
imagen	l'image	[sound:l'image.mp3]
impresión	l'impression	[sound:l'impression.mp3]
pierna	la jambe	[sound:la jambe.mp3]
alegría	la joie	[sound:la joie.mp3]
diá	la journée	[sound:la journée.mp3]
lengua	la langue	[sound:la langue.mp3]
letra	la lettre	[sound:la lettre.mp3]
labio	la lèvre	[sound:la lèvre.mp3]
línea	la ligne	[sound:la ligne.mp3]
luz	la lumière	[sound:la lumière.mp3]
señora	la madame	[sound:la madame.mp3]
mano	la main	[sound:la main.mp3]
casa	la maison	[sound:la maison.mp3]
mamá	la maman	[sound:la maman.mp3]
manera	la manière	[sound:la manière.mp3]
escalón	la marche	[sound:la marche.mp3]
mierda	la merde	[sound:la merde.mp3]
madre	la mère	[sound:la mère.mp3]
minuto	la minute	[sound:la minute.mp3]
música	la musique	[sound:la musique.mp3]
noche	la nuit	[sound:la nuit.mp3]
olor	l'odeur	[sound:l'odeur.mp3]
sombra	l'ombre	[sound:l'ombre.mp3]
oreja	l'oreille	[sound:l'oreille.mp3]
paz	la paix	[sound:la paix.mp3]
palabra	la parole	[sound:la parole.mp3]
parte	la part	[sound:la part.mp3]
parte	la partie	[sound:la partie.mp3]
piel	la peau	[sound:la peau.mp3]
pena	la peine	[sound:la peine.mp3]
pensamiento	la pensée	[sound:la pensée.mp3]
persona	la personne	[sound:la personne.mp3]
miedo	la peur	[sound:la peur.mp3]
foto	la photo	[sound:la photo.mp3]
pieza	la pièce	[sound:la pièce.mp3]
piedra	la pierre	[sound:la pierre.mp3]
plaza	la place	[sound:la place.mp3]
bolsillo	la poche	[sound:la poche.mp3]
policía	la police	[sound:la police.mp3]
puerta	la porte	[sound:la porte.mp3]
presencia	la présence	[sound:la présence.mp3]
cárcel	la prison	[sound:la prison.mp3]
prostituta	la putain	[sound:la putain.mp3]
cuestión	la question	[sound:la question.mp3]
razón	la raison	[sound:la raison.mp3]
respuesta	la réponse	[sound:la réponse.mp3]
vestido	la robe	[sound:la robe.mp3]
carretera	la route	[sound:la route.mp3]
sala	la salle	[sound:la salle.mp3]
escena	la scène	[sound:la scène.mp3]
segundo	la seconde	[sound:la seconde.mp3]
seguridad	la sécurité	[sound:la sécurité.mp3]
semana	la semaine	[sound:la semaine.mp3]
situación	la situation	[sound:la situation.mp3]
hermana	la soeur	[sound:la soeur.mp3]
noche	la soirée	[sound:la soirée.mp3]
tipo	la sorte	[sound:la sorte.mp3]
seguida	la suite	[sound:la suite.mp3]
mesa	la table	[sound:la table.mp3]
tierra	la terre	[sound:la terre.mp3]
cabeza	la tête	[sound:la tête.mp3]
torre	la tour	[sound:la tour.mp3]
verdad	la vérité	[sound:la vérité.mp3]
ciudad	la ville	[sound:la ville.mp3]
coche	la voiture	[sound:la voiture.mp3]
voz	la voix	[sound:la voix.mp3]
acuerdo	l'accord	[sound:l'accord.mp3]
agente	l'agent	[sound:l'agent.mp3]
amor	l'amour	[sound:l'amour.mp3]
llamada	l'appel	[sound:l'appel.mp3]
árbol	l'arbre	[sound:l'arbre.mp3]
dinero	l'argent	[sound:l'argent.mp3]
futuro	l'avenir	[sound:l'avenir.mp3]
avión	l'avion	[sound:l'avion.mp3]
opinión	l'avis	[sound:l'avis.mp3]
barco	le bateau	[sound:le bateau.mp3]
bebé	le bébé	[sound:le bébé.mp3]
necesidad	le besoin	[sound:le besoin.mp3]
madera	le bois	[sound:le bois.mp3]
alegría	le bonheur	[sound:le bonheur.mp3]
buenos días	le bonjour	[sound:le bonjour.mp3]
orilla	le bord	[sound:le bord.mp3]
trabajo (coloquial)	le boulot	[sound:le boulot.mp3]
trozo	le bout	[sound:le bout.mp3]
brazo	le bras	[sound:le bras.mp3]
ruido	le bruit	[sound:le bruit.mp3]
despcho	le bureau	[sound:le bureau.mp3]
café	le café	[sound:le café.mp3]
campo	le camp	[sound:le camp.mp3]
capitán	le capitaine	[sound:le capitaine.mp3]
gato	le chat	[sound:le chat.mp3]
jefe	le chef	[sound:le chef.mp3]
camino	le chemin	[sound:le chemin.mp3]
cariño	le chéri	[sound:le chéri.mp3]
caballo	le cheval	[sound:le cheval.mp3]
pelo	le cheveu	[sound:le cheveu.mp3]
perro	le chien	[sound:le chien.mp3]
elección	le choix	[sound:le choix.mp3]
cielo	le ciel	[sound:le ciel.mp3]
cliente	le client	[sound:le client.mp3]
corazón	le cœur	[sound:le cœur.mp3]
esquina	le coin	[sound:le coin.mp3]
coronel	le colonel	[sound:le colonel.mp3]
cuenta	le compte	[sound:le compte.mp3]
novio	le copain	[sound:le copain.mp3]
cuerpo	le corps	[sound:le corps.mp3]
lado	le côté	[sound:le côté.mp3]
golpe	le coup	[sound:le coup.mp3]
corriente	le courant	[sound:le courant.mp3]
clase	le cours	[sound:le cours.mp3]
inicio	le début	[sound:le début.mp3]
partida	le départ	[sound:le départ.mp3]
dios	le dieu	[sound:le dieu.mp3]
doctor	le docteur	[sound:le docteur.mp3]
dedo	le doigt	[sound:le doigt.mp3]
dólar	le dollar	[sound:le dollar.mp3]
duda	le doute	[sound:le doute.mp3]
derecho	le droit	[sound:le droit.mp3]
efecto	l'effet	[sound:l'effet.mp3]
lugar	l'endroit	[sound:l'endroit.mp3]
niño	l'enfant	[sound:l'enfant.mp3]
enemigo	l'ennemi	[sound:l'ennemi.mp3]
escalera	l'escalier	[sound:l'escalier.mp3]
mente	l'esprit	[sound:l'esprit.mp3]
estado	l'état	[sound:l'état.mp3]
ser	l'être	[sound:l'être.mp3]
ejemplo	l'exemple	[sound:l'exemple.mp3]
hecho	le fait	[sound:le fait.mp3]
película	le film	[sound:le film.mp3]
hijo	le fils	[sound:le fils.mp3]
policía (coloquial)	le flic	[sound:le flic.mp3]
fondo	le fond	[sound:le fond.mp3]
francés	le français	[sound:le français.mp3]
hermano	le frère	[sound:le frère.mp3]
frente	le front	[sound:le front.mp3]
chico	le garçon	[sound:le garçon.mp3]
guarda	le garde	[sound:le garde.mp3]
chico (coloquial)	le gars	[sound:le gars.mp3]
general	le général	[sound:le général.mp3]
género	le genre	[sound:le genre.mp3]
gente	le gens	[sound:le gens.mp3]
gesto	le geste	[sound:le geste.mp3]
niño (coloquial)	le gosse	[sound:le gosse.mp3]
sabor	le goût	[sound:le goût.mp3]
gobierno	le gouvernement	[sound:le gouvernement.mp3]
grupo	le groupe	[sound:le groupe.mp3]
hombre	le homme	[sound:le homme.mp3]
honor	le honneur	[sound:le honneur.mp3]
hotel	l'hôtel	[sound:l'hôtel.mp3]
momento	l'instant	[sound:l'instant.mp3]
interés	l'intérêt	[sound:l'intérêt.mp3]
interior	l'intérieur	[sound:l'intérieur.mp3]
jardín	le jardin	[sound:le jardin.mp3]
día	le jour	[sound:le jour.mp3]
periódico	le journal	[sound:le journal.mp3]
lugar	le lieu	[sound:le lieu.mp3]
libro	le livre	[sound:le livre.mp3]
maestro	le maître	[sound:le maître.mp3]
marido	le mari	[sound:le mari.mp3]
boda	le mariage	[sound:le mariage.mp3]
la mañana	le matin	[sound:le matin.mp3]
médico	le médecin	[sound:le médecin.mp3]
gracias	le merci	[sound:le merci.mp3]
metro	le mètre	[sound:le mètre.mp3]
medio	le milieu	[sound:le milieu.mp3]
millón	le million	[sound:le million.mp3]
mes	le mois	[sound:le mois.mp3]
momento	le moment	[sound:le moment.mp3]
mundo	le monde	[sound:le monde.mp3]
señor	le monsieur	[sound:le monsieur.mp3]
muerte	le mort	[sound:le mort.mp3]
movimiento	le mouvement	[sound:le mouvement.mp3]
medio	le moyen	[sound:le moyen.mp3]
nuevo	le nouveau	[sound:le nouveau.mp3]
número	le numéro	[sound:le numéro.mp3]
ojo	l'oeil	[sound:l'oeil.mp3]
pájaro	l'oiseau	[sound:l'oiseau.mp3]
tío	l'oncle	[sound:l'oncle.mp3]
orden	l'ordre	[sound:l'ordre.mp3]
papá	le papa	[sound:le papa.mp3]
papel	le papier	[sound:le papier.mp3]
padres	le parent	[sound:le parent.mp3]
paso	le passage	[sound:le passage.mp3]
pasado	le passé	[sound:le passé.mp3]
patrón	le patron	[sound:le patron.mp3]
país	le pays	[sound:le pays.mp3]
padre	le père	[sound:le père.mp3]
pequeño	le petit	[sound:le petit.mp3]
pueblo	le peuple	[sound:le peuple.mp3]
pie	le pied	[sound:le pied.mp3]
placer	le plaisir	[sound:le plaisir.mp3]
plan	le plan	[sound:le plan.mp3]
punto	le point	[sound:le point.mp3]
poder	le pouvoir	[sound:le pouvoir.mp3]
primero	le premier	[sound:le premier.mp3]
presente	le présent	[sound:le présent.mp3]
presidente	le président	[sound:le président.mp3]
príncipe	le prince	[sound:le prince.mp3]
precio	le prix	[sound:le prix.mp3]
problema	le problème	[sound:le problème.mp3]
profesor	le professeur	[sound:le professeur.mp3]
palabras	le propos	[sound:le propos.mp3]
barrio	le quartier	[sound:le quartier.mp3]
relación	le rapport	[sound:le rapport.mp3]
mirada	le regard	[sound:le regard.mp3]
resto	le reste	[sound:le reste.mp3]
retraso	le retard	[sound:le retard.mp3]
vuelta	le retour	[sound:le retour.mp3]
sueño	le rêve	[sound:le rêve.mp3]
saludo	le salut	[sound:le salut.mp3]
sangre	le sang	[sound:le sang.mp3]
secreto	le secret	[sound:le secret.mp3]
señor (espiritual)	le seigneur	[sound:le seigneur.mp3]
sentido	le sens	[sound:le sens.mp3]
sentimiento	le sentiment	[sound:le sentiment.mp3]
servicio	le service	[sound:le service.mp3]
siglo	le siècle	[sound:le siècle.mp3]
señal	le signe	[sound:le signe.mp3]
silencio	le silence	[sound:le silence.mp3]
noche	le soir	[sound:le soir.mp3]
soldado	le soldat	[sound:le soldat.mp3]
sol	le soleil	[sound:le soleil.mp3]
sonrisa	le sourire	[sound:le sourire.mp3]
recuerdo	le souvenir	[sound:le souvenir.mp3]
tema	le sujet	[sound:le sujet.mp3]
teléfono	le téléphone	[sound:le téléphone.mp3]
tiempo	le temps	[sound:le temps.mp3]
todo	le tout	[sound:le tout.mp3]
tren	le train	[sound:le train.mp3]
trabajo	le travail	[sound:le travail.mp3]
rareza	le travers	[sound:le travers.mp3]
hueco	le trou	[sound:le trou.mp3]
cosa (coloquial)	le truc	[sound:le truc.mp3]
tipo	le type	[sound:le type.mp3]
viento	le vent	[sound:le vent.mp3]
barriga	le ventre	[sound:le ventre.mp3]
vaso	le verre	[sound:le verre.mp3]
viejo	le vieux	[sound:le vieux.mp3]
pueblo	le village	[sound:le village.mp3]
cara	le visage	[sound:le visage.mp3]
viaje	le voyage	[sound:le voyage.mp3]
abandonar	abandonner	[sound:abandonner.mp3]
aceptar	accepter	[sound:accepter.mp3]
acompañar	accompagner	[sound:accompagner.mp3]
comprar	acheter	[sound:acheter.mp3]
adorar	adorer	[sound:adorer.mp3]
actuar	agir	[sound:agir.mp3]
ayudar	aider	[sound:aider.mp3]
gustar	aimer	[sound:aimer.mp3]
añadir	ajouter	[sound:ajouter.mp3]
ir	aller	[sound:aller.mp3]
traer	amener	[sound:amener.mp3]
divertir	amuser	[sound:amuser.mp3]
anunciar	annoncer	[sound:annoncer.mp3]
percibir	apercevoir	[sound:apercevoir.mp3]
aparecer	apparaître	[sound:apparaître.mp3]
llamar	appeler	[sound:appeler.mp3]
traer	apporter	[sound:apporter.mp3]
aprender	apprendre	[sound:apprendre.mp3]
acercarse	approcher	[sound:approcher.mp3]
arreglar	arranger	[sound:arranger.mp3]
parar	arrêter	[sound:arrêter.mp3]
llegar	arriver	[sound:arriver.mp3]
sentarse	asseoir	[sound:asseoir.mp3]
asegurar	assurer	[sound:assurer.mp3]
atacar	attaquer	[sound:attaquer.mp3]
alcanzar	atteindre	[sound:atteindre.mp3]
esperar	attendre	[sound:attendre.mp3]
avanzar	avancer	[sound:avancer.mp3]
tener	avoir	[sound:avoir.mp3]
bajar	baisser	[sound:baisser.mp3]
golpear	battre	[sound:battre.mp3]
beber	boire	[sound:boire.mp3]
mover	bouger	[sound:bouger.mp3]
quemar	brûler	[sound:brûler.mp3]
esconder	cacher	[sound:cacher.mp3]
calmar	calmer	[sound:calmer.mp3]
romper	casser	[sound:casser.mp3]
parar	cesser	[sound:cesser.mp3]
cambiar	changer	[sound:changer.mp3]
cantar	chanter	[sound:chanter.mp3]
cargar	charger	[sound:charger.mp3]
buscar	chercher	[sound:chercher.mp3]
elegir	choisir	[sound:choisir.mp3]
empezar	commencer	[sound:commencer.mp3]
entender	comprendre	[sound:comprendre.mp3]
contar	compter	[sound:compter.mp3]
conducir	conduire	[sound:conduire.mp3]
conocer	connaître	[sound:connaître.mp3]
continuar	continuer	[sound:continuer.mp3]
dormir	coucher	[sound:coucher.mp3]
cortar	couper	[sound:couper.mp3]
correr	courir	[sound:courir.mp3]
cubrir	couvrir	[sound:couvrir.mp3]
tener miedo	craindre	[sound:craindre.mp3]
gritar	crier	[sound:crier.mp3]
creer	croire	[sound:croire.mp3]
bailar	danser	[sound:danser.mp3]
decidir	décider	[sound:décider.mp3]
descubrir	découvrir	[sound:découvrir.mp3]
despejar	dégager	[sound:dégager.mp3]
preguntar	demander	[sound:demander.mp3]
bajar	descendre	[sound:descendre.mp3]
entristecer	désoler	[sound:désoler.mp3]
odiar	détester	[sound:détester.mp3]
destruir	détruire	[sound:détruire.mp3]
convertirse en	devenir	[sound:devenir.mp3]
adivinar	deviner	[sound:deviner.mp3]
deber	devoir	[sound:devoir.mp3]
decir	dire	[sound:dire.mp3]
desaparecer	disparaître	[sound:disparaître.mp3]
dar	donner	[sound:donner.mp3]
dormir	dormir	[sound:dormir.mp3]
escapar	échapper	[sound:échapper.mp3]
escuchar	écouter	[sound:écouter.mp3]
escribir	écrire	[sound:écrire.mp3]
alejar	éloigner	[sound:éloigner.mp3]
besar	embrasser	[sound:embrasser.mp3]
llevar	emmener	[sound:emmener.mp3]
impedir	empêcher	[sound:empêcher.mp3]
llevar	emporter	[sound:emporter.mp3]
quitar	enlever	[sound:enlever.mp3]
oír	entendre	[sound:entendre.mp3]
entrar	entrer	[sound:entrer.mp3]
enviar	envoyer	[sound:envoyer.mp3]
esperar	espérer	[sound:espérer.mp3]
intentar	essayer	[sound:essayer.mp3]
ser	être	[sound:être.mp3]
evitar	éviter	[sound:éviter.mp3]
perdonar	excuser	[sound:excuser.mp3]
existir	exister	[sound:exister.mp3]
explicar	expliquer	[sound:expliquer.mp3]
hacer	faire	[sound:faire.mp3]
hacer falta	falloir	[sound:falloir.mp3]
cerrar	fermer	[sound:fermer.mp3]
dar (coloquial)	filer	[sound:filer.mp3]
acabar	finir	[sound:finir.mp3]
hacer (muy coloquial)	foutre	[sound:foutre.mp3]
golpear	frapper	[sound:frapper.mp3]
ganar	gagner	[sound:gagner.mp3]
guardar	garder	[sound:garder.mp3]
resbalar	glisser	[sound:glisser.mp3]
vivir	habiter	[sound:habiter.mp3]
ignorar	ignorer	[sound:ignorer.mp3]
imaginar	imaginer	[sound:imaginer.mp3]
importar	importer	[sound:importer.mp3]
preocupar	inquiéter	[sound:inquiéter.mp3]
instalar	installer	[sound:installer.mp3]
interesar	intéresser	[sound:intéresser.mp3]
invitar	inviter	[sound:inviter.mp3]
tirar	jeter	[sound:jeter.mp3]
jugar	jouer	[sound:jouer.mp3]
jurar	jurer	[sound:jurer.mp3]
soltar	lâcher	[sound:lâcher.mp3]
dejar	laisser	[sound:laisser.mp3]
tirar	lancer	[sound:lancer.mp3]
levantar	lever	[sound:lever.mp3]
leer	lire	[sound:lire.mp3]
mantener	maintenir	[sound:maintenir.mp3]
comer	manger	[sound:manger.mp3]
faltar	manquer	[sound:manquer.mp3]
caminar	marcher	[sound:marcher.mp3]
casar	marier	[sound:marier.mp3]
mandar	mener	[sound:mener.mp3]
mentir	mentir	[sound:mentir.mp3]
poner	mettre	[sound:mettre.mp3]
subir	monter	[sound:monter.mp3]
mostrar	montrer	[sound:montrer.mp3]
morir	mourir	[sound:mourir.mp3]
nacer	naître	[sound:naître.mp3]
obligar	obliger	[sound:obliger.mp3]
ocupar	occuper	[sound:occuper.mp3]
regalar	offrir	[sound:offrir.mp3]
atreverse	oser	[sound:oser.mp3]
olvidar	oublier	[sound:oublier.mp3]
abrir	ouvrir	[sound:ouvrir.mp3]
parecer	paraître	[sound:paraître.mp3]
hablar	parler	[sound:parler.mp3]
marcharse	partir	[sound:partir.mp3]
pasar	passer	[sound:passer.mp3]
pagar	payer	[sound:payer.mp3]
pensar	penser	[sound:penser.mp3]
perder	perdre	[sound:perdre.mp3]
permitir	permettre	[sound:permettre.mp3]
gustarle a alguien	plaire	[sound:plaire.mp3]
llorar	pleurer	[sound:pleurer.mp3]
llevar algo	porter	[sound:porter.mp3]
colocar	poser	[sound:poser.mp3]
empujar	pousser	[sound:pousser.mp3]
poder	pouvoir	[sound:pouvoir.mp3]
preferir	préférer	[sound:préférer.mp3]
tomar	prendre	[sound:prendre.mp3]
preparar	préparer	[sound:préparer.mp3]
presentar	présenter	[sound:présenter.mp3]
avisar	prévenir	[sound:prévenir.mp3]
rezar	prier	[sound:prier.mp3]
prometer	promettre	[sound:promettre.mp3]
ofrecer algo	proposer	[sound:proposer.mp3]
proteger	protéger	[sound:protéger.mp3]
dejar	quitter	[sound:quitter.mp3]
contar	raconter	[sound:raconter.mp3]
volver a llevar	ramener	[sound:ramener.mp3]
volver a llamar	rappeler	[sound:rappeler.mp3]
recibir	recevoir	[sound:recevoir.mp3]
reconocer	reconnaître	[sound:reconnaître.mp3]
pensar	réfléchir	[sound:réfléchir.mp3]
rechazar	refuser	[sound:refuser.mp3]
mirar	regarder	[sound:regarder.mp3]
reunirse	rejoindre	[sound:rejoindre.mp3]
notar	remarquer	[sound:remarquer.mp3]
devolver	remettre	[sound:remettre.mp3]
volver a subir	remonter	[sound:remonter.mp3]
encontrar	rencontrer	[sound:rencontrer.mp3]
devolver	rendre	[sound:rendre.mp3]
volver	rentrer	[sound:rentrer.mp3]
repetir	répéter	[sound:répéter.mp3]
contestar	répondre	[sound:répondre.mp3]
descansar	reposer	[sound:reposer.mp3]
volver a servirse	reprendre	[sound:reprendre.mp3]
parecer a	ressembler	[sound:ressembler.mp3]
quedarse	rester	[sound:rester.mp3]
memorizar	retenir	[sound:retenir.mp3]
quitar	retirer	[sound:retirer.mp3]
voltear	retourner	[sound:retourner.mp3]
volver a encontrar	retrouver	[sound:retrouver.mp3]
tener éxito	réussir	[sound:réussir.mp3]
despertar	réveiller	[sound:réveiller.mp3]
volver	revenir	[sound:revenir.mp3]
soñar	rêver	[sound:rêver.mp3]
ver de nuevo	revoir	[sound:revoir.mp3]
réir	rire	[sound:rire.mp3]
arriesgar	risquer	[sound:risquer.mp3]
rodar	rouler	[sound:rouler.mp3]
saltar	sauter	[sound:sauter.mp3]
salvar	sauver	[sound:sauver.mp3]
saber	savoir	[sound:savoir.mp3]
parecer	sembler	[sound:sembler.mp3]
sentir	sentir	[sound:sentir.mp3]
separar	séparer	[sound:séparer.mp3]
apretar	serrer	[sound:serrer.mp3]
servir	servir	[sound:servir.mp3]
salir	sortir	[sound:sortir.mp3]
sufrir	souffrir	[sound:souffrir.mp3]
sonreir	sourire	[sound:sourire.mp3]
acordarse	souvenir	[sound:souvenir.mp3]
ser suficiente	suffire	[sound:suffire.mp3]
seguir	suivre	[sound:suivre.mp3]
callar	taire	[sound:taire.mp3]
extender	tendre	[sound:tendre.mp3]
sostener	tenir	[sound:tenir.mp3]
intentar	tenter	[sound:tenter.mp3]
terminar	terminer	[sound:terminer.mp3]
tirar	tirer	[sound:tirer.mp3]
caer	tomber	[sound:tomber.mp3]
tocar	toucher	[sound:toucher.mp3]
girar	tourner	[sound:tourner.mp3]
arrastrar	traîner	[sound:traîner.mp3]
tratar	traiter	[sound:traiter.mp3]
trabajar	travailler	[sound:travailler.mp3]
atravesar	traverser	[sound:traverser.mp3]
engañar	tromper	[sound:tromper.mp3]
encontrar	trouver	[sound:trouver.mp3]
matar	tuer	[sound:tuer.mp3]
utilizar	utiliser	[sound:utiliser.mp3]
valer	valoir	[sound:valoir.mp3]
vender	vendre	[sound:vendre.mp3]
venir	venir	[sound:venir.mp3]
vivir	vivre	[sound:vivre.mp3]
ver	voir	[sound:voir.mp3]
volar	voler	[sound:voler.mp3]
querer	vouloir	[sound:vouloir.mp3]
saludos y cortesía	salutations et courtoisie	[sound:salutations et courtoisie.mp3]
buenos días	bonjour	[sound:bonjour.mp3]
señor	monsieur	[sound:monsieur.mp3]
señora	madame	[sound:madame.mp3]
hola	salut	[sound:salut.mp3]
gracias	merci	[sound:merci.mp3]
hasta luego	au revoir	[sound:au revoir.mp3]
hasta pronto	à bientôt	[sound:à bientôt.mp3]
perdón	pardon	[sound:pardon.mp3]
disculpe	excusez-moi	[sound:excusez-moi.mp3]
por favor	s'il vous plait	[sound:s'il vous plait.mp3]
los pronombres (sujeto)	les pronoms (sujet)	[sound:les pronoms (sujet).mp3]
yo	je	[sound:je.mp3]
tu	tu	[sound:tu.mp3]
el/ella	il /elle	[sound:il _elle.mp3]
impersonal<br> nosotros	on	[sound:on.mp3]
nosotros	nous	[sound:nous.mp3]
vosotros, ustedes	vous	[sound:vous.mp3]
ellos/ellas	ils /elles	[sound:ils _elles.mp3]
articulos y determinantes	articles et déterminants	[sound:articles et déterminants.mp3]
el/la/los o las	le /la /les	[sound:le _la _les.mp3]
uno/una/un@s	un /une /des	[sound:un _une _des.mp3]
este/esta/est@s	ce /cette /ces	[sound:ce _cette _ces.mp3]
mi/mis	mon /ma /mes	[sound:mon _ma _mes.mp3]
preguntas y respuestas	questions et réponses	[sound:questions et réponses.mp3]
quien	qui	[sound:qui.mp3]
cuándo	quand	[sound:quand.mp3]
dónde	où	[sound:où.mp3]
por qué	pourquoi	[sound:pourquoi.mp3]
cómo	comment	[sound:comment.mp3]
cuánto	combien	[sound:combien.mp3]
cuál	quel /quelle	[sound:quel _quelle.mp3]
sí	oui	[sound:oui.mp3]
no	non	[sound:non.mp3]
de acuerdo	d'accord	[sound:d'accord.mp3]
tal vez	peut-être	[sound:peut-être.mp3]
adjetivos frecuentes	adjectifs fréquents	[sound:adjectifs fréquents.mp3]
pesado/a	lourd(e)	[sound:lourd(e).mp3]
ligero/a	léger(e)	[sound:léger(e).mp3]
rápido	rapide(e)	[sound:rapide(e).mp3]
lento	lent(e)	[sound:lent(e).mp3]
feo/a	moche	[sound:moche.mp3]
simpático/a	sympa	[sound:sympa.mp3]
normal	normal(e)	[sound:normal(e).mp3]
soltero/a	célibataire	[sound:célibataire.mp3]
casado/a	marié(e)	[sound:marié(e).mp3]
divorciado/a	divorcé(e)	[sound:divorcé(e).mp3]
rico/a	riche	[sound:riche.mp3]
inteligente	intelligent(e)	[sound:intelligent(e).mp3]
idiota	bête	[sound:bête.mp3]
pésimo/a	nul(le)	[sound:nul(le).mp3]
peor	pire	[sound:pire.mp3]
corto/a	court(e)	[sound:court(e).mp3]
izquierdo/a	gauche	[sound:gauche.mp3]
derecho/a	droit(e)	[sound:droit(e).mp3]
adverbios frecuentes	adverbes fréquents	[sound:adverbes fréquents.mp3]
ayer	hier	[sound:hier.mp3]
hoy	aujourd'hui	[sound:aujourd'hui.mp3]
mañana	demain	[sound:demain.mp3]
ahora	maintenant	[sound:maintenant.mp3]
siempre	toujours	[sound:toujours.mp3]
muchas veces	souvent	[sound:souvent.mp3]
a veces	parfois	[sound:parfois.mp3]
jamás	jamais	[sound:jamais.mp3]
antes	avant	[sound:avant.mp3]
después	après	[sound:après.mp3]
aquí	ici	[sound:ici.mp3]
allí	là	[sound:là.mp3]
allá	là-bas	[sound:là-bas.mp3]
hasta	jusqu'à	[sound:jusqu'à.mp3]
encima	sur	[sound:sur.mp3]
debajo	sous	[sound:sous.mp3]
en, dentro	dans	[sound:dans.mp3]
en	en	[sound:en.mp3]
a	à	[sound:à.mp3]
por todos lados	partout	[sound:partout.mp3]
un poco	un peu	[sound:un peu.mp3]
mucho	beaucoup	[sound:beaucoup.mp3]
muy	très	[sound:très.mp3]
demasiado	trop	[sound:trop.mp3]
bastante	assez	[sound:assez.mp3]
más	plus	[sound:plus.mp3]
menos	moins	[sound:moins.mp3]
con	avec	[sound:avec.mp3]
sin	sans	[sound:sans.mp3]
también	aussi	[sound:aussi.mp3]
como	comme	[sound:comme.mp3]
aún, todavía	encore	[sound:encore.mp3]
realmente, de verdad	vraiment	[sound:vraiment.mp3]
casi	presque	[sound:presque.mp3]
el cabello	les cheveux	[sound:les cheveux.mp3]
la nariz	le nez	[sound:le nez.mp3]
el cuello	le cou	[sound:le cou.mp3]
el dedo	doigt	[sound:doigt.mp3]
la espalda	le dos	[sound:le dos.mp3]
la pierna	jambe	[sound:jambe.mp3]
el corazón	le coeur	[sound:le coeur.mp3]
la garganta	gorge	[sound:gorge.mp3]
la salud	la santé	[sound:la santé.mp3]
el hospital	l'hôpital	[sound:l'hôpital.mp3]
el resfriado	le froid	[sound:le froid.mp3]
la fiebre	la fièvre	[sound:la fièvre.mp3]
la receta	la recette	[sound:la recette.mp3]
el medicamento	le médicament	[sound:le médicament.mp3]
la farmacia	la pharmacie	[sound:la pharmacie.mp3]
los padres	parents	[sound:parents.mp3]
el padre (papá)	le père (papa)	[sound:le père (papa).mp3]
la madre (mamá)	la mère (maman)	[sound:la mère (maman).mp3]
la hermana	la sœur	[sound:la sœur.mp3]
los niños, hijos	enfants enfants	[sound:enfants enfants.mp3]
el hijo/a	le fils / la fille	[sound:le fils _ la fille.mp3]
los abuelos	les grands-parents	[sound:les grands-parents.mp3]
el abuelo (abuelito)	grand-père (grand-père)	[sound:grand-père (grand-père).mp3]
la abuela (abuelita)	grand-mère (mamie)	[sound:grand-mère (mamie).mp3]
la tía	la tante	[sound:la tante.mp3]
el primo/a	le cousin	[sound:le cousin.mp3]
el futuro	le futur	[sound:le futur.mp3]
el mes	mois	[sound:mois.mp3]
enero	janvier	[sound:janvier.mp3]
febrero	février	[sound:février.mp3]
marzo	mars	[sound:mars.mp3]
abril	avril	[sound:avril.mp3]
mayo	mai	[sound:mai.mp3]
junio	juin	[sound:juin.mp3]
julio	juillet	[sound:juillet.mp3]
agosto	août	[sound:août.mp3]
septiembre	septembre	[sound:septembre.mp3]
octubre	octobre	[sound:octobre.mp3]
noviembre	novembre	[sound:novembre.mp3]
diciembre	décembre	[sound:décembre.mp3]
la primavera	le printemps	[sound:le printemps.mp3]
el verano	l'été	[sound:l'été.mp3]
el otoño	l'automne	[sound:l'automne.mp3]
el invierno	l'hiver	[sound:l'hiver.mp3]
el lunes	lundi	[sound:lundi.mp3]
el martes	le mardi	[sound:le mardi.mp3]
el miércoles	mercredi	[sound:mercredi.mp3]
el jueves	jeudi	[sound:jeudi.mp3]
el viernes	le vendredi	[sound:le vendredi.mp3]
el sábado	samedi	[sound:samedi.mp3]
el domingo	le dimanche	[sound:le dimanche.mp3]
el fin de semana	la fin de semaine	[sound:la fin de semaine.mp3]
el mediodía	midi	[sound:midi.mp3]
fin de tarde	tard dans l'après-midi	[sound:tard dans l'après-midi.mp3]
la hora	l'heure	[sound:l'heure.mp3]
el segundo	le deuxième	[sound:le deuxième.mp3]
la fecha	date	[sound:date.mp3]
el fin	la fin	[sound:la fin.mp3]
el tiempo (el clima)	l'heure (la météo)	[sound:l'heure (la météo).mp3]
el clima	le climat	[sound:le climat.mp3]
la nube	le nuage	[sound:le nuage.mp3]
la lluvia	la pluie	[sound:la pluie.mp3]
la ropa	les vêtements	[sound:les vêtements.mp3]
la camisa	chemise	[sound:chemise.mp3]
la playera	la chemise	[sound:la chemise.mp3]
el suéter	pull	[sound:pull.mp3]
el pantalón	le pantalon	[sound:le pantalon.mp3]
la falda	jupe	[sound:jupe.mp3]
el calcetín	la chaussette	[sound:la chaussette.mp3]
el zapato	la chaussure	[sound:la chaussure.mp3]
la chaqueta	la veste	[sound:la veste.mp3]
el abrigo	le manteau	[sound:le manteau.mp3]
las gafas, lentes	lunettes, verres	[sound:lunettes, verres.mp3]
el reloj	la montre	[sound:la montre.mp3]
la bolsa	la bourse	[sound:la bourse.mp3]
el billete	le billet	[sound:le billet.mp3]
la moneda	monnaie	[sound:monnaie.mp3]
el pago	le paiement	[sound:le paiement.mp3]
el banco	la banque	[sound:la banque.mp3]
la cuenta	l'addition	[sound:l'addition.mp3]
el cajero automático	distributeur automatique	[sound:distributeur automatique.mp3]
la cartera	portefeuille	[sound:portefeuille.mp3]
las actividades	les activités	[sound:les activités.mp3]
el deporte	le sport	[sound:le sport.mp3]
el cinema	le cinéma	[sound:le cinéma.mp3]
la salida	la sortie	[sound:la sortie.mp3]
el bar	le bar	[sound:le bar.mp3]
el restaurante	le restaurant	[sound:le restaurant.mp3]
el tele	la télé	[sound:la télé.mp3]
la serie	la série	[sound:la série.mp3]
la canción	la chanson	[sound:la chanson.mp3]
los transportes	les transports	[sound:les transports.mp3]
la moto	la moto	[sound:la moto.mp3]
la bicicleta	le vélo	[sound:le vélo.mp3]
el taxi	le taxi	[sound:le taxi.mp3]
la estación	la station	[sound:la station.mp3]
el aeropuerto	l'aéroport	[sound:l'aéroport.mp3]
geografia y ciudades	géographie et villes	[sound:géographie et villes.mp3]
el mar	la mer	[sound:la mer.mp3]
la región	la région	[sound:la région.mp3]
la calle	la rue	[sound:la rue.mp3]
el ayuntamiento	la mairie	[sound:la mairie.mp3]
el supermercado	le supermarché	[sound:le supermarché.mp3]
la panadería	la boulangerie	[sound:la boulangerie.mp3]
la tienda	la boutique	[sound:la boutique.mp3]
el salón	le salon	[sound:le salon.mp3]
la habitación, recámara	la chambre, la chambre	[sound:la chambre, la chambre.mp3]
el cuartos de baño	la salle de bain	[sound:la salle de bain.mp3]
los baños, aseos	les salles de bain, toilettes	[sound:les salles de bain, toilettes.mp3]
el garaje	le garage	[sound:le garage.mp3]
el apartamento, piso	l'appartement, étage	[sound:l'appartement, étage.mp3]
el piso, planta	le sol, plante	[sound:le sol, plante.mp3]
la silla	la chaise	[sound:la chaise.mp3]
el armario	l'armoire	[sound:l'armoire.mp3]
la cama	le lit	[sound:le lit.mp3]
el sofá	le canapé	[sound:le canapé.mp3]
la comida	le repas	[sound:le repas.mp3]
la sed	soif	[sound:soif.mp3]
la bebida	la boisson	[sound:la boisson.mp3]
el agua	l'eau	[sound:l'eau.mp3]
el vino	le vin	[sound:le vin.mp3]
la cerveza	la bière	[sound:la bière.mp3]
el te	le thé	[sound:le thé.mp3]
el café	café	[sound:café.mp3]
el jugo	le jus	[sound:le jus.mp3]
la fruta	le fruit	[sound:le fruit.mp3]
la verdura	légume	[sound:légume.mp3]
la carne	la viande	[sound:la viande.mp3]
el pescado	le poisson	[sound:le poisson.mp3]
el huevo	l'oeuf	[sound:l'oeuf.mp3]
el pan	pain	[sound:pain.mp3]
la comida, almuerzo	la nourriture, le déjeuner	[sound:la nourriture, le déjeuner.mp3]
el plato	l'assiette	[sound:l'assiette.mp3]
el cuchillo	couteau	[sound:couteau.mp3]
el tenedor	la fourchette	[sound:la fourchette.mp3]
la cuchara	la cuillère	[sound:la cuillère.mp3]
la botella	la bouteille	[sound:la bouteille.mp3]
la reservación	la réservation	[sound:la réservation.mp3]
el menú	le menu	[sound:le menu.mp3]
la entrada	l'entrée	[sound:l'entrée.mp3]
el plato fuerte	le plat principal	[sound:le plat principal.mp3]
el postre	le dessert	[sound:le dessert.mp3]
los estudios	les études	[sound:les études.mp3]
la clase	classe	[sound:classe.mp3]
el diploma	le diplome	[sound:le diplome.mp3]
la empresa	l'entreprise	[sound:l'entreprise.mp3]
el colega	le collègue	[sound:le collègue.mp3]
la junta	planche	[sound:planche.mp3]
la entrevista	l'interview	[sound:l'interview.mp3]
el contrato	le contrat	[sound:le contrat.mp3]
el sueldo	le salaire	[sound:le salaire.mp3]
las vacaciones	les vacances	[sound:les vacances.mp3]
la profesión	la profession	[sound:la profession.mp3]
el empleado	l'employé	[sound:l'employé.mp3]
el director	le directeur	[sound:le directeur.mp3]
el profesor	professeur	[sound:professeur.mp3]
el vendedor	le vendeur	[sound:le vendeur.mp3]
el ingeniero	l'ingénieur	[sound:l'ingénieur.mp3]
el bombero	le pompier	[sound:le pompier.mp3]
el jubilado	le retraité	[sound:le retraité.mp3]
la gente y las relaciones	les gens et les relations	[sound:les gens et les relations.mp3]
la persona	personne	[sound:personne.mp3]
la gente	les gens	[sound:les gens.mp3]
alguien	quelqu'un	[sound:quelqu'un.mp3]
la niña	la petite fille	[sound:la petite fille.mp3]
el hombre	l'homme	[sound:l'homme.mp3]
el amigo	l'ami	[sound:l'ami.mp3]
el sentimiento	sentiment	[sound:sentiment.mp3]
el novio/a	le petit ami / petite amie	[sound:le petit ami _ petite amie.mp3]
la pareja	le couple	[sound:le couple.mp3]
la boda,matrimonio	le mariage, le mariage	[sound:le mariage, le mariage.mp3]
la esposa. esposa	femme. épouse	[sound:femme. épouse.mp3]
las etapas de la vida	les étapes de la vie	[sound:les étapes de la vie.mp3]
la vida	la vie	[sound:la vie.mp3]
la edad	l'âge	[sound:l'âge.mp3]
el nacimiento	la naissance	[sound:la naissance.mp3]
el adolescente	l'adolescent	[sound:l'adolescent.mp3]
el adulto	l'adulte	[sound:l'adulte.mp3]
la comunicación	la communication	[sound:la communication.mp3]
la platica	le discours	[sound:le discours.mp3]
el móvil	le mobile	[sound:le mobile.mp3]
el mensaje de texto	message texte	[sound:message texte.mp3]
el sonido	sonner	[sound:sonner.mp3]
la computadora	l'ordinateur	[sound:l'ordinateur.mp3]
el correo electrónico	le courriel	[sound:le courriel.mp3]
el correo	le courrier	[sound:le courrier.mp3]
la hoja	la feuille	[sound:la feuille.mp3]
la pluma	stylo	[sound:stylo.mp3]
el sobre	enveloppe	[sound:enveloppe.mp3]
el timbre	la sonnette	[sound:la sonnette.mp3]
la oficina de correos	la poste	[sound:la poste.mp3]
la emergencia	l'urgence	[sound:l'urgence.mp3]
cuidado	fais attention	[sound:fais attention.mp3]
ayuda!	aidez-moi!	[sound:aidez-moi!.mp3]
la necesidad	la nécessité	[sound:la nécessité.mp3]
socorro	au secours	[sound:au secours.mp3]
el pasaporte	le passeport	[sound:le passeport.mp3]
el robo	le vol	[sound:le vol.mp3]
los conectores	les connecteurs	[sound:les connecteurs.mp3]
y	et	[sound:et.mp3]
primero	d'abord	[sound:d'abord.mp3]
después, luego	ensuite	[sound:ensuite.mp3]
por último	enfin	[sound:enfin.mp3]
pero	mais	[sound:mais.mp3]
porque	parce que	[sound:parce que.mp3]
pues	donc	[sound:donc.mp3]
entonces	alors	[sound:alors.mp3]
por ejemplo	par exemple	[sound:par exemple.mp3]
por cierto	au fait	[sound:au fait.mp3]
si no	sinon	[sound:sinon.mp3]
nada	rien	[sound:rien.mp3]
cosa	chose	[sound:chose.mp3]
algo	quelque , chose	[sound:quelque , chose.mp3]
vez	fois	[sound:fois.mp3]
parte	partie	[sound:partie.mp3]
razón	raison	[sound:raison.mp3]
palabrotas	gros mots	[sound:gros mots.mp3]
mierda	merde	[sound:merde.mp3]
joder, puta	putain	[sound:putain.mp3]
